Harry Potter	Gryffindor	DADA,Transfiguration,Potions,Flying
Ron Weasley	Gryffindor	DADA,Transfiguration,Potions,Flying
Dean Thomas	Gryffindor	DADA,Transfiguration,Flying,Charms
Ginny Weasley	Gryffindor	DADA,Transfiguration,Potions,Flying
Oliver Wood	Gryffindor	Flying,Transfiguration,DADA,Charms
Draco Malfoy	Slytherin	Potions,Transfiguration,DarkArts,Flying
Gregory Goyle	Slytherin	Potions,Transfiguration,DarkArts
Vincent Crabbe	Slytherin	Potions,Transfiguration,DarkArts
Zacharias Smith	Hufflepuff	Transfiguration,DADA,Charms,Flying
Hannah Abbott	Hufflepuff	Transfiguration,DADA,Charms,Herbology
Ernie Macmillan	Hufflepuff	Transfiguration,DADA,Charms,Potions
Cho Chang	Ravenclaw	Flying,Transfiguration,DADA,Charms
Luna Lovegood	Ravenclaw	Divination,Charms,DADA,Herbology,Transfiguration
Roger Davies	Ravenclaw	Transfiguration,DADA,Charms,Potions,Flying
Hermione Granger	Gryffindor	DADA,Transfiguration,Potions,Charms,Arithmancy,HistoryofMagic
Nevile Longbottom	Gryffindor	DADA,Charms,Herbology,Potions
Percy Weasley	Gryffindor	Arithmancy,HistoryofMagic,Charms,Transfiguration,Potions
Pansy Parkinson	Slytherin	Potions,Transfiguration,DarkArts
Parvati Patil	Gryffindor	Divination,Transfiguration,Charms,Herbology
Padma Patil	Ravenclaw	Divination,Transfiguration,Charms,Herbology